控制台
Proever-XYS 于28天前修改了此页面。
 Warning:花1分钟创建用户后就能进行编辑 :)  
Evant space debris.png
查看关联内容
Message diplomatic alliance.png 
这篇文章需要改进。你可以帮助群星中文维基来 编辑它。
控制台（console），是群星（Stellaris）中用于修改，调试的一个控制器。

注意，本页面中的+号大多指空格。注意想知道名称或者需要可以输入debugtooltip来实现。

注：铁人模式不可使用！（通过修改器可以绕过）

本页内容很长，请使用浏览器页面搜索功能快速定位
呼出
按下~呼出控制台

铁人模式下依然可以呼出，但是所有指令无效，关于铁人模式下的修改请移步改派教程。
使用WeMod的修改器可以开启Console/Dev Mode in Ironman，即可以在铁人模式下使用控制台。
代号
由于部分名称过长，因此P社采用代号来简化，具体代号为同类型的加载顺序（即：特质的代号即为特质的加载顺序，例如traits下的文件名按照升序排列，然后每个文件内的按照从上到下的顺序递增），代号从0开始。

目前并非所有指令都可以使用代号
effect组合命令
effect命令可以跟一些命令或者预置脚本组合成一组控制台命令，如：

与add_modifier（为所选星球添加修正）、remove_modifier（为所选星球移除修正）等控制台命令组合（参见文末附录）
effect = { reroll_deposits = yes }可以为所选星球重新生成矿藏
effect = { clear_blockers = yes }可以清理所选星球的障碍
也可以用更复杂的组合，例如effect = { begin_event_chain = { event_chain = "baol_chain"} }可以开启巴奥事件链（但没后续效果）
所有的组合可以参见 Stellaris\common\scripted_effects\ 目录下的预置脚本文档。如果开了MOD，那么MOD里的预置脚本同样可以。

更多组合详见控制台/常见组合

指令
注：如果增加的资源数超过1000000，可能增加的资源会归0。


相关附加代码（点击下列链接即可跳转到对应表格位置）

1.指令列表
2.星球类型
3.资源列表
4.飞升天赋
5.领袖特质
6.科技列表
7.事件列表
在控制台中可以输入的指令：

2.0版本更新部分指令失效(已修正部分指令)

作弊类型	代码	备注
添加战略资源	planet_resource <战略资源代码> <数值>	为指定的行星添加 战略资源（活金属,育兰晶体，中子矿石之类），不加具体数值或者具体资源代码会无法使用。
投降	surrender <x（投降者编号）> <y（战胜者编号）>	使x在对y的战斗中投降。
战争	war <进攻方国家代码> <防御方国家代码> <进攻方战争目标>	使一个国家向另一个国家宣战。
战争目标：[wg_colossus]全面战争 [wg_humiliation]羞辱 [wg_independence]独立 [wg_conquest]征服 [需要补充更多战争目标]

崩溃	crash	使游戏崩溃
POP死亡	kill_pop pop ID	使目标ID的POP死亡
国家灭亡	kill_country <国家代码>	使目标ID的国家瞬间灭亡
统治者死亡	kill_ruler ID	使目标ID的统治者死亡
领导人死亡	kill_leader 领导人ID	使目标ID的领导人死亡
修改星球大小	planet_size <数值>	修改选定星球的大小，如果是可居住星球(包括轨道居住地)，也会改变地块数量。
修改星球大小	planetsize <数值>	修改选定星球的大小，如果是可居住星球(包括轨道居住地)，也会改变地块数量。
修改星球类型	planet_class <星球类型代码>	修改选定星球的星球类型
未选定时修改所有行星和天然卫星(包括轨道栖息地和已建成的环世界，不包括恒星、小行星)。
修改星球类型	planetclass <星球类型代码>	修改选定星球的星球类型
未选定时修改所有行星和天然卫星(包括轨道栖息地和已建成的环世界，不包括恒星、小行星)。
自由政府状态	free_government	切换政府为自由政府。
获得星球的所有权	own <数值>	占有id为<数值>的星球，若为未殖民星球则会产生一个主体种族人口。没标明数值时占有选定星球或恒星基地。
所有资源	rr	只输入rr,增加所有资源至上限。经实测，未拥有开采科技的稀有战略资源（天然气，沼气等）不会有任何增加。
舰船	add_ship <舰船设计名称>	在你选定的物品旁增加一艘舰船。舰船设计可以是预置的舰船设计方案（global_ship_design）
增加异常点	add_anomaly	在星球上增加一个异常点，异常点列表见project:查询表/异常点。
在选定的星球上添加资源	effect add_deposit =	在选定的星球上（最好是无人的）添加各种战略资源，最多10个单位。
凝聚力	unity <数值>	增加<数值>数量的 Unity.png凝聚力。只输入unity，不加具体数值，会增加500凝聚力。
合金	alloys <数值>	增加<数值>数量的Alloys.png合金。只输入alloys不加具体数值，会增加5000合金。
能源	energy <数值>	增加<数值>数量的Energy.png能量币。只输入energy或cash，不加具体数值，会增加5000能量币。
能源	cash <数值>	增加<数值>数量的Energy.png能量币。只输入energy或cash，不加具体数值，会增加5000能量币。
工业科研点数	engineering <数值>	增加<数值>数量的Engineering research.png工程学研究。只输入engineering，不加具体数值，会增加5000工程学点数。
食物	food <数值>	增加<数值>数量的Food.png食物。只输入food不加具体数值，会增加5000食物。
影响力	influence <数值>	增加<数值>数量的Influence.png影响力。只输入influence，不加具体数值，会增加5000影响力（不开instant_build时会超过上限，所以实际只加到上限值）。
矿物	minerals <数值>	增加<数值>数量的Minerals.png矿物。只输入minerals不加具体数值，会增加5000矿物。
物理学点数	physics <数值>	增加<数值>数量的Physics research.png物理学研究。只输入physics，不加具体数值，会增加5000物理学点数。
社会研究点数	society <数值>	增加<数值>数量的Society research.png社会学研究。只输入society，不加具体数值，会增加5000社会学点数。
增加灾飞威慑度	menace <数值>	增加天灾飞升的数值，无法一次性增至满级，需要研究对应科技继续增加即可
伤害	damage <数值>	对选定的舰队造成<数值>点伤害。（需要注意的是，这个伤害的来源将被认为是来自于空玩家）
瞬间完成当前科技	finish_research	将当前所有科研槽的研发项目与特殊项目(如果存在)的进度更改为100%，于第二天结束研究
填满星球人口	populate	将选定星球填满人口(注意：该指令对机械帝国和非机械帝国均有效。但在新的2.2版本及以上对于非机械帝国，该指令对目标行星仅能生效一次，特定情况下使目标行星人口正好超出住房上限，建造增加住房的区划和建筑，使可用住房为正值时可再次使用该指令。对于机械帝国，populate指令仍可生效且增加的pop数偶尔多于非机械帝国殖民相同的行星后使用该指令)。如需为目标行星添加非装配的"自然增长人口(非机器pop)"需使用“grow_pops+[自然增长进度1的数量(以下简称数量)]”指令进行添加，装配的"非自然增长人口(机器pop)"可用“build_pops+[数量]"指令增加。
舰队瞬间移动	tweakergui instant_move	开关命令 创建一个开关舰队瞬间移动的窗口
同意条约	yesmen或debug_yesmen	开关命令AI总是同意玩家提出的条约（包括共同防御、组建联邦、停战协议、交易等）
拒绝条约	nomen或debug_nomen	开关命令AI总是拒绝玩家提出的条约
选定即拥有	own paint	开关命令开启后，选定的星球均会被玩家占有。
选定即控制	control paint	开关命令开启后，选定的星球均会被玩家控制。
舰船无敌	invincible	开关命令我方舰队/空间站的闪避率提高到100%，因此不受伤害。
信息	debugtooltip	开关命令查看id、效果、flag等隐藏信息，可以用于验证MOD效果的工具（无法查看种群id,要查看种群id还请改派）
瞬间建造	instant_build	开关命令瞬间建造（包括升级太空港、添加太空港插槽模块），且建造费用为0，注意陆军、建造太空港需要第二天完成。
如果开启瞬间建造之前已经有队列，则需要第二天才能完成。瞬间建造不包括机械人口。警告：这也适用于敌人AI。
新一轮选举	election	开始新一轮选举
指令列表	TAB键	按下TAB可查看常用作弊指令列表。
控制星球	control <数值>	控制（相当于陆军占领后的状态）id为<数值>的星球，没标明数值时控制选定星球或恒星基地。太空港归控制者。若双方未交战则自动归还。
星球类型统计	planets	显示各种类型星球的数目的统计值及百分比。
资源点统计	deposits	显示各种资源点（deposit）的数目的统计值级百分比（因为会统计空白，所以百分比意义不大）。
科技权重	techweights <phy/soc/eng>	显示当前的物理／社会／工程科技的权重，权重越大，下一个出现的概率越高。
帮助	help <作弊指令>	查看该作弊指令的使用方法。不加具体指令显示所有作弊指令列表。
瞬间殖民	instant_colony	殖民船瞬间殖民(宜居度够即可)
更换国家	play <数值>	玩id为<数值>的国家，包括失落帝国、原始文明、太空城邦、野怪、天灾等势力
更换国家	tag <数值>	玩id为<数值>的国家，包括失落帝国、原始文明、太空城邦、野怪、天灾等势力
瞬间完成特殊项目	finish_special_projects	瞬间完成状态日志中所有特殊项目，事件链项目容易产生bug。
科技全开(1.0.X-2.0.1)	research_technologies	瞬间研究所有科技。数值1为1时包括事件和飞升科技，0不包括，数值2为循环科技等级。
可以省去数值2，也可以两个均省去。两数值默认值均为0
注：

research_technologies 1 X 会让游戏卡顿一段时间，数值小卡顿不明显，数值越大卡顿越久，数值过大(与电脑性能有关)可直接卡死
循环层数过高，科研需求值可能溢出而变为负数，此时显示需求值为0，可以瞬间(次日)完成
科技全开(2.0.2-未来版本）	research_all_technologies <数值1><数值2>	瞬间研究所有科技。数值1为事件武器和天灾武器和飞升武器 1为研究 0为不研究，数值2为循环科技等级
注：

指令格式：research_all_technologires X X为循环科技等级
research_all_technologies 1 X 会让游戏卡顿一段时间，数值小卡顿不明显，数值越大卡顿越久，数值过大(与电脑性能有关)可直接卡死(v2.0.2略有好转，但数值过大依然会卡死，2.3版本后已修复此bug，但仍然有机会卡死，具体表现在是否有异常研究、或者类似弹窗事件在同时完成。建议用此指令前存档，读档后在暂停状态下输入此条指令，循环层数经测试，500层比较舒服-_d)
循环层数过高，科研需求值可能溢出而变为负数，此时显示需求值为0，可以瞬间(次日)完成
2.0.3 2.0.4 2.0.5无法通过本指令解锁特殊科技，如事件武器（包括天灾武器、巨像武器等），但可以使用 research_technology XX (XX为科技名)来解锁指定科技
2.1以后如果拥有遥远的群星DLC 那么 research_all_technologies 1 X 会导致L星门线索收集完成也无法打开L星门 解决方法百度贴吧有或者在圈了L星门后再进行科技
瞬间研究某项科技(2.0.2-未来版本）	research_technology <科技代码>	瞬间研究指定科技。
瞬间调查	survey	瞬间调查所有星球。危机警告:会导致先驱者任务线卡住
观察全宇宙	observe	观察全宇宙和全宇宙的生物(观海模式)，但是无法造船，有一定bug。
解锁传统和飞升槽	activate_all_traditions	解锁所有传统并解锁和传统数量一样的飞升槽，如加载更多飞升槽MOD只需多收入几次
解锁传统后传统呈灰色未解锁状态，保存重新加载即可

事件	event <事件id> <触发事件>	触发编号为<id>的事件，注意，ship_event需要选择舰船来触发，planet_event需要选择星球来触发，country_event一般不需要选取即可触发。部分被触发事件可能由于没有对象和不满足条件等原因触发出现问题
更换科技列表	techupdate	重新生成可用科技的列表。
GUI隐藏	nogui	隐藏GUI。
注：开关命令在奇数次输入时开启对应的效果，偶数次输入时关闭对应的效果。
官方wiki 控制台指令

指令列表
文中带有 <> 符号代表着需要你执行某些动作让指令正确运行。比如 <Select Planet> 意味着先在游戏中选中一个星球后再输入并执行控制台指令。如果你需要知道某些事物的 ID 你可以在控制台中使用以下代码tweakergui debugtooltip(pre 1.1) 或者 debugtooltip(1.1)。特殊的 ID 将会在特殊信息栏内显示。
指令
Command	说明
Description	指令参数
Parameters	示例
Example
help	显示一个指令的帮助文档。	[指令名]
[command name]	help human_ai
helphelp	才不会给你帮助呢！哼！	看什么看！？	别..别添啊！
3dstats	开关命令3D统计信息。显示FPS和渲染时间	无	3dstats
achievement_status	非开关命令打印成就状态。到底能干什么？	无	achievement_status
finish_research	完成所有当前的研究。	无	finish_research
finish_special_projects	完成所有特殊项目。	无	finish_special_projects
activate_ascension_perk
<天赋名>	激活飞升天赋，把 ap 放在天赋名前。	无	activate_ascension_perk ap_mind_over_matter
activate_tradition <名字>	激活传统 （需要使用 debugtooltip 获取名字）。	无	activate_tradition tr_prosperity_sct
add_anomaly	为星球添加异常点(类)。	[异常点类名]
[anomaly category name]	<Select Planet> add_anomaly life_asteroid_category
add_ethic_pop	给人口添加思潮。	[Pop ID] [Ethic Key]	add_ethic_pop purged ethic_fanatic_collectivist
add_opinion	增加 '甲' 对 '乙' 的好感度(可以使用负数减少好感度)。	[甲][乙][数额]
[target country id] [target country id] [amount]	add_opinion 01 00 500
add_ship	创建一艘指定型号的舰船。	[design name]	add_ship Avatar
create_navy	创建一个舰队，使用你最新的设计	create_navy [战力]1表示100%	create_navy 0.8
add_spynetwork_value	增加间谍网络价值。在[目标]上增加[数量]渗透进度	[target] [amount] 
[目标][数量]

add_spynetwork_value 1 1000
add_trait_leader	给领袖添加特性。	[领袖ID] [特性名或索引]
[leader id] [trait key or index]	add_trait_leader 1 leader_trait_gale_speed
add_trait_species	给物种添加特性。	[物种ID] [特性名]
[species id] [trait key]	add_trait_species 5 intelligent
ai	开关命令开关AI。	无	ai
alienfx	尝试使用Alien FX改变电脑的灯光。	无	TODO
ambient_object	产生指定类型的环境对象。	[type]	ambient_object medium_debris_02_object
attackallfleets	使所有舰队瞄准所有其他舰队。	无	TODO
cash	添加 [数量] 能源币。默认为5000。	[数额]
[amount]	cash 500
colonize	复制一个给予的人口开始选中星球的殖民过程。	<select planet> [colonizer pop id]	<select planet> colonize 1
communications	开关命令开关所有交易。	[目标国家ID]
[target country id]	TODO
contact	开关命令开关所有提案。	无	contact
control	用于占领行星。如果与[planet id]的拥有者没有战争，控制权会立即恢复。	[planet id]	control 50
copy_pop	使用 ID 复制一个人口至选中的星球。	[pop id]	copy_pop 1247
crash	使游戏崩溃。	无	crash
create_megastructure	创建一个特定的巨型建筑。	[megastructure id]	create_megastructure think_tank_1
damage	选择舰船造成 x 伤害。	<选中舰船>
<Select Ship>	damage 50
debug_nomen	所有AI控制的国家永远不同意你的交易和提案。	无	debug_nomen
debug_yesmen	所有AI控制的国家永远同意你的交易和提案。	无	debug_yesmen
force_integrate	迫使目标国家合并至玩家国家。	force_integrate [国家id]	force_integrate 5
effect shift_ethic =	改变国家思潮	[Ethic Key]	Ethic gestalt consciousness.png格式塔意识：effect shift_ethic = ethic_gestalt_consciousness
Ethic fanatic militarist.png极端军国主义：effect shift_ethic = ethic_fanatic_militarist
Ethic fanatic xenophobe.png极端排外主义：effect shift_ethic = ethic_fanatic_xenophobe
Ethic fanatic egalitarian.png极端平等主义：effect shift_ethic = ethic_fanatic_egalitarian
Ethic fanatic materialist.png极端唯物主义：effect shift_ethic = ethic_fanatic_materialist
Ethic fanatic pacifist.png极端和平主义：effect shift_ethic = ethic_fanatic_pacifist
Ethic fanatic xenophile.png极端亲外主义：effect shift_ethic = ethic_fanatic_xenophile
Ethic fanatic authoritarian.png极端威权主义：effect shift_ethic = ethic_fanatic_authoritarian
Ethic fanatic spiritualist.png极端唯心主义：effect shift_ethic = ethic_fanatic_spiritualist
(不想要“极端”的话，请去掉“fanatic_”)。
democratic_election	开始民主统治者选举。	无	TODO
election	开始一个统治者的选举。	无	election
federation_add_experience	增加联盟等级经验，默认1000	[数额]
[amount]	federation_add_experience 1000
federation_add_cohesion	增加联盟团结度，默认200	[数额]
[amount]	federation_add_cohesion 200
federation_add_cohesion_speed	增加联盟每月团结度，默认10	[数额]
[amount]	federation_add_cohesion_speed 10
federation_examine_leader	立即选举联盟主席	无	federation_examine_leader
free_government	开关命令允许玩家在没有时间限制的情况下改革政府(每次20年的限制)	无	free_government
free_policies	开关命令允许玩家更改政策而不受限制，包括以前禁用的策略。	无	free_policies
engineering	添加工程技术点。 默认为5000。	[数额]
[amount]	engineering 500
error	在日志中显示错误。	无	error
event	执行一个事件。	[事件ID] [目标ID]
[event id] [target id]	event story.5
event crisis.
10/100/1000/2000	执行末日危机事件：
“10” 开始 Prethoryn Swarm，
“100” 群虫女王 子事件，
“1000” 次元入侵者
“2000” AI 暴乱。	[event id] crisis.[target id]	event crisis.1000
eventscopes	显示当前事件的范围树。	无	<Event open> eventscopes
eventstats	显示事件统计信息。	无	eventstats
fast_forward	快进至设置的天数。
（快进时按下ESC可终止快进）

该代码是让玩家挂机到指定天数，快进期间其它帝国以及相关事件依旧在进行。

唯一不同的就是玩家帝国一直在原地挂机。

[amount of days]
（无效）[observer]

fast_forward 100
ftl	开关命令开关无限制FTL。	无	ftl
fullscreen	开关命令切换至全屏。	无	fullscreen
game_over	执行指定的游戏结束类型。	[胜利类型索引]
[victory type index]	game_over 0
goto	移动视角至[x] [y]	[x] [y]	goto 10 10
grow_pops	添加一个成长中的人口至选中的星球。在指令后添加数字加快成长。数值对应人口	无	<Select Planet> grow_pops 100
hdr	开关命令切换 HDR。	无	hdr
hsv	将RGB转换为HSV。	无	hsv 25 25 25
human_ai	开关命令将玩家帝国托管给电脑。
玩家依旧可以操作帝国，但是无法抉择大部分事件以及外交提案。

无	human_ai
influence	添加 [数量] 的影响力。默认为5000.	[数额]
[amount]	influence 500
info	开关命令开关Debug信息。	无	info
instant_build	开关命令会立即完成地表建筑物，升级，舰船，站点的建造。警告：这同样适用于敌方AI。	无	instant_build
invincible	玩家的舰队将不会受到伤害。	无	invincible
kill_country	玩家当前主控的帝国直接灭亡。	无	kill_country
kill_leader	杀死指定的领袖。	[leader id]	kill_leader ?
kill_pop	杀死当前的人口	[pop id]	kill_pop 745
kill_ruler	杀死当前的统治者。	无	Kills current ruler.
lockcamera	锁定视角到当前的位置。	[debug_lockcamera, lockcamera]	lockcamera
map_names	重新生成地图名称。	无	map_names
mature_galaxy	危险代码
模拟一个100年后的银河系。

该外码会强制将年份定在开局+100年的时间点上，即便当时已经过了100年。会引发游戏逻辑错误导致崩溃。

无	mature_galaxy
message	在顶栏显示所有类型的信息。	无	message
minerals	添加矿物。默认为5000。	[数额]
[amount]	minerals 500
nogui	开关命令切换GUI。	无	nogui
nomouse	开关命令切换鼠标滚轮	无	nomouse
observe	开启观海模式	无	observe
overnight	把游戏设置成通宵模式。	[ticks per turn]	overnight 2
own	获取指定星球的所有权和控制权。	[planet id] [paint]	own 5
path	在星系之间寻找路径。	[from index] [to index]	path 0 1
physics	添加物理技术点。默认为5000。	[数额]
[amount]	physics 500
planet_class	改变选中的星球类型至指定的类型。	[planet class name]	<Select Planet> planet_class pc_tropical
planet_happiness	增加选中星球的幸福度，具体来说，向选中星球添加了一个增加幸福度的buff，但是，不会超过因为其他因素影响的最大幸福度。	[数额]
[amount]	<Select Planet> planet_happiness 100
planet_resource	添加资源到资源块，每块地的资源数量是随机的，总和就是输入的数额。	[资源类型] [数额]
[resource] [amount]	<Select Planet> planet_resource minerals 50
新版本2.2.X废弃
planet_size	调整星球和地表块的大小，最大的地表块尺寸为25块，但是星球的大小可以在25之后继续增加。警告：极端大小能、也将会破坏游戏。	[planet size]	<Select Planet> planet_size 25
planets	列出每一种类型的行星和每个行星的数量。	无	planets
play	允许你使用两位数的ID切换游玩的帝国。00是玩家的帝国，AI帝国是01及以上。	[tag] [country index]	play 01
pop_happiness	与 tweakergui 一起使用. 使人口幸福度达到特定的等级。	无	tweakergui pop_happiness
pp	给予玩家矿物	[数额]
[amount]	pp 1000
random_ruler	用一个新的随机统治者替换当前统治者。	无	random_rulerrandom_ruler
recalc_fleet_presence	重新计算舰队驻留缓存，如果载入旧存档则很有用。	无	recalc_fleet_presence
reload	重新加载 assets	[file name]	reload main.gui
reload_galaxy	重新加载系统初始化脚本以及重新生成星系。	无	TODO
reload_graphical_map	重新加载图形地图。	无	reload_graphical_map
reloadfx	重新加载着色器。	[arguments: map/mapname/postfx or *.fx filename]	reloadfx arrow
remove_ethic_pop	移除一个选中的人口的一个思潮。	[pop id] [ethic key]	remove_ethic_pop ? ethic_xenophobe
remove_notification	移除所有属于玩家的所有通知。	[数额]
[amount]	remove_notification 1
remove_trait_leader	移除领袖特质。	[leader id] [trait key or index]	remove_trait_leader 17 trait_leader_meticulous
remove_trait_species	移除物种特质。	[species id] [trait key]	remove_trait_species 5 intelligent
rendertype	显示当前的渲染类型。	无	rendertype
research_technologies	立即研究所有非循环科技的科技。	布尔值
Boolean	(如果参数为1)立即研究所有科技，包括生物和末日危机科技。
resource	添加 [数量] 于 [资源]。 默认为5000。	[数额]
[amount]	resource minerals 500
resources	显示星球资源。	无	resources
reverse_diplo	从目标派遣一个外交指挥官到玩家。	[diplo] [id]	reverse_diplo action_invite_to_alliance 01
skills	为每个玩家控制的领袖添加一定数额的技能等级。	[数额]
[amount]	skills 5 所有领袖等级+5
society	添加社会技术点。默认为5000。	[数额]
[amount]	society 500
surrender	投降并同意所有要求。只使用 [country id] 来列出该国家正在进行的所有战争的编号。	[country id] [war id]	List all wars for country with country_id = 5 along with their war_ids: surrender 5. Force country with country_id = 5 to surrender in war with war_id = 19975: surrender 5 19975.
survey	探索所有星球。	无	survey
observe	在地图上展示一切，但你不能游玩。使用play x指令，恢复游玩。	无	observe
play x	在观察命令[observe]之后继续游玩。	无	play x
techupdate	重新生成玩家的科技树。	无	techupdate
terraforming_resources	设定星球上特殊资源的数量。	[数额]
[amount]	<Select Planet> terraforming_resources 10
unlock_edicts	提供颁布任何法令的能力，以及不能用于玩家使用的法令。	无	unlock_edicts
unity	添加凝聚力。	[数额]
[amount]	unity 500
volume	修改音乐音量	[volume delta]	volume 20
（代码已确认无效）war_on_player	迫使目标国家向玩家宣战。	[country id]	war_on_player 05
warscore	为帝国所有激活的战争添加给予的战争分数。	[数额]
[amount]	warscore 75
effect add_deposit =	为选定星球添加对应资源	[Planetary Deposits]	<Select Planet> effect add_deposit = d_exotic_gases_1
注：开关命令在奇数次输入时开启对应的效果，偶数次输入时关闭对应的效果。
附录
由于篇幅限制，部分列表移至相关子页面，点击链接即可查看详细列表

推荐使用wiki检索器来搜索相关分类的key
数据集合

飞升列表
访问专题
这些可以用于 activate_ascension_perk 命令。与其他命令的用法还未确认。
飞升天赋列表

名称	代码	代号
Ap lord of war.pngEmpire flag 64 frame.png战争之王	activate_ascension_perk ap_lord_of_war	0
Ap become the crisis.pngEmpire flag 64 frame.png化身天灾	activate_ascension_perk ap_become_the_crisis	1
Ap hydrocentric.pngEmpire flag 64 frame.png水之心	activate_ascension_perk ap_hydrocentric	2
Ap enigmatic engineering.pngEmpire flag 64 frame.png天机工程	activate_ascension_perk ap_enigmatic_engineering	3
Ap nihilistic acquisition.pngEmpire flag 64 frame.png强取豪夺	activate_ascension_perk ap_nihilistic_acquisition	4
Ap colossus.pngEmpire flag 64 frame.png巨像计划	activate_ascension_perk ap_colossus	5
Ap engineered evolution.pngEmpire flag 64 frame.png设计进化	activate_ascension_perk ap_engineered_evolution	6
Ap evolutionary mastery.pngEmpire flag 64 frame.png掌控进化	activate_ascension_perk ap_evolutionary_mastery	7
Ap the flesh is weak.pngEmpire flag 64 frame.png血肉苦弱	activate_ascension_perk ap_the_flesh_is_weak	8
Ap synthetic evolution.pngEmpire flag 64 frame.png合成进化	activate_ascension_perk ap_synthetic_evolution	9
Ap mind over matter.pngEmpire flag 64 frame.png心胜于物	activate_ascension_perk ap_mind_over_matter	10
Ap transcendence.pngEmpire flag 64 frame.png超凡入圣	activate_ascension_perk ap_transcendence	11
Ap world shaper.pngEmpire flag 64 frame.png星球塑形师	activate_ascension_perk ap_world_shaper	12
Ap galactic force projection.pngEmpire flag 64 frame.png星河力量投射	activate_ascension_perk ap_galactic_force_projection	13
Ap defender of the galaxy.pngEmpire flag 64 frame.png星河卫士	activate_ascension_perk ap_defender_of_the_galaxy	14
Ap interstellar dominion.pngEmpire flag 64 frame.png星际主权	activate_ascension_perk ap_interstellar_dominion	15
Ap grasp the void.pngEmpire flag 64 frame.png掌握太虚	activate_ascension_perk ap_grasp_the_void	16
Ap eternal vigilance.pngEmpire flag 64 frame.png戒心永存	activate_ascension_perk ap_eternal_vigilance	17
Ap galactic contender.pngEmpire flag 64 frame.png逐鹿星河	activate_ascension_perk ap_galactic_contender	18
Ap technological ascendancy.pngEmpire flag 64 frame.png科技至上	activate_ascension_perk ap_technological_ascendancy	19
Ap one vision.pngEmpire flag 64 frame.png万众一心	activate_ascension_perk ap_one_vision	20
Ap consecrated worlds.pngEmpire flag 64 frame.png祝圣世界	activate_ascension_perk ap_consecrated_worlds	21
Ap mastery of nature.pngEmpire flag 64 frame.png掌控自然	activate_ascension_perk ap_mastery_of_nature	22
Ap imperial prerogative.pngEmpire flag 64 frame.png中央特权	activate_ascension_perk ap_imperial_prerogative	23
Ap executive vigor.pngEmpire flag 64 frame.png高效行政	activate_ascension_perk ap_executive_vigor	24
Ap transcendent learning.pngEmpire flag 64 frame.png卓越学术	activate_ascension_perk ap_transcendent_learning	25
Ap shared destiny.pngEmpire flag 64 frame.png共同命运	activate_ascension_perk ap_shared_destiny	26
Ap voidborn.pngEmpire flag 64 frame.png太空子民	activate_ascension_perk ap_voidborn	27
Ap master builders.pngEmpire flag 64 frame.png建筑大师	activate_ascension_perk ap_master_builders	28
Ap galactic wonders.pngEmpire flag 64 frame.png星河奇迹	activate_ascension_perk ap_galactic_wonders_utopia	29
Ap galactic wonders.pngEmpire flag 64 frame.png星河奇迹	activate_ascension_perk ap_galactic_wonders_megacorp	30
Ap galactic wonders.pngEmpire flag 64 frame.png星河奇迹	activate_ascension_perk ap_galactic_wonders_utopia_and_megacorp	31
Ap synthetic age.pngEmpire flag 64 frame.png合成时代	activate_ascension_perk ap_synthetic_age	32
Ap machine worlds.pngEmpire flag 64 frame.png机械世界	activate_ascension_perk ap_machine_worlds	33
Ap hive worlds.pngEmpire flag 64 frame.png蜂巢星球	activate_ascension_perk ap_hive_worlds	34
Ap arcology project.pngEmpire flag 64 frame.png理想城计划	activate_ascension_perk ap_arcology_project	35
Ap xeno compatibility.pngEmpire flag 64 frame.png跨物种杂交	activate_ascension_perk ap_xeno_compatibility	36
Ap universal transactions.pngEmpire flag 64 frame.png寰宇贸易	activate_ascension_perk ap_universal_transactions	37
注意！三个星河奇迹只有最后一个和下面列表中的是可以用的！

飞升名字	代码
水之心	activate_ascension_perk ap_hydrocentric（非水生种族可用）
化身天灾	activate_ascension_perk ap_become_the_crisis
星河奇迹	activate_ascension_perk ap_galactic_wonders_utopia_and_megacorp
星球类型列表
访问专题
这些可以用于 planet_class 命令。与其他命令的用法还未确认。
星球类型列表

名称	代码	代号
沙漠星球	planet_class pc_desert	0
干旱星球	planet_class pc_arid	1
草原星球	planet_class pc_savannah	2
热带星球	planet_class pc_tropical	3
陆地星球	planet_class pc_continental	4
海洋星球	planet_class pc_ocean	5
苔原星球	planet_class pc_tundra	6
极地星球	planet_class pc_arctic	7
高山星球	planet_class pc_alpine	8
气态巨行星	planet_class pc_gas_giant	9
小行星	planet_class pc_asteroid	10
冰晶小行星	planet_class pc_ice_asteroid	11
晶态小行星	planet_class pc_rare_crystal_asteroid	12
熔融星球	planet_class pc_molten	13
荒芜星球	planet_class pc_barren	14
荒芜星球	planet_class pc_barren_cold	15
剧毒星球	planet_class pc_toxic	16
冰封星球	planet_class pc_frozen	17
死寂星球	planet_class pc_nuked	18
蜂巢星球	planet_class pc_hive	19
机械星球	planet_class pc_machine	20
屏障星球	planet_class pc_shielded	21
人工智能星球	planet_class pc_ai	22
孵化星球	planet_class pc_infested	23
盖亚星球	planet_class pc_gaia	24
环形世界	planet_class pc_cybrex	25
B型恒星	planet_class pc_b_star	26
A型恒星	planet_class pc_a_star	27
F型恒星	planet_class pc_f_star	28
G型恒星	planet_class pc_g_star	29
K型恒星	planet_class pc_k_star	30
M型恒星	planet_class pc_m_star	31
M型红巨星	planet_class pc_m_giant_star	32
T型褐矮星	planet_class pc_t_star	33
黑洞	planet_class pc_black_hole	34
中子星	planet_class pc_neutron_star	35
脉冲星	planet_class pc_pulsar	36
环形世界	planet_class pc_ringworld_habitable	37
破损的环形世界	planet_class pc_ringworld_habitable_damaged	38
环形世界	planet_class pc_ringworld_tech	39
破损的环形世界	planet_class pc_ringworld_tech_damaged	40
环形世界	planet_class pc_ringworld_seam	41
破损的环形世界	planet_class pc_ringworld_seam_damaged	42
破碎之环	planet_class pc_shattered_ring_habitable	43
轨道居住站	planet_class pc_habitat	44
虚境星球	planet_class pc_shrouded	45
崩坏星球	planet_class pc_broken	46
粉碎星球	planet_class pc_shattered	47
纳米星球	planet_class pc_gray_goo	48
破碎星球	planet_class pc_egg_cracked	49
晶态小行星	planet_class pc_crystal_asteroid	50
被屏蔽的环形世界区段	planet_class pc_ringworld_shielded	51
被屏蔽的居住站	planet_class pc_habitat_shielded	52
都市星球	planet_class pc_city	53
遗落星球	planet_class pc_relic	54
粉碎星球	planet_class pc_shattered_2	55
资源列表
访问专题
这些可以用于 resource 命令。与其他命令的用法还未确认。
资源列表

名称	代码	代号
Time.png时间	resource time	0
Energy.png能量币	resource energy	1
Minerals.png矿物	resource minerals	2
Food.png食物	resource food	3
Physics research.png物理学研究	resource physics_research	4
Society research.png社会学研究	resource society_research	5
Engineering research.png工程学研究	resource engineering_research	6
Influence.png影响力	resource influence	7
Unity.png凝聚力	resource unity	8
Consumer goods.png消费品	resource consumer_goods	9
Alloys.png合金	resource alloys	10
Volatile motes.png易爆微粒	resource volatile_motes	11
Exotic gases.png异星天然气	resource exotic_gases	12
Rare crystals.png稀有水晶	resource rare_crystals	13
Sr living metal.png活体金属	resource sr_living_metal	14
Sr zro.png泽珞	resource sr_zro	15
Sr dark matter.png暗物质	resource sr_dark_matter	16
Nanites.png纳米机器人	resource nanites	17
Minor artifacts.png稀有文物	resource minor_artifacts	18
Menace.png威慑力	resource menace	19
资源添加给非生命星球代码如下：
一次性可以加1-10的（加在代码末尾，如effect add_deposit = d_energy_8，就可以给选定星球加8点能量币）此处往后数值用n代替
Energy.png能量币 effect add_deposit=d_energy_n
Minerals.png矿物 effect add_deposit=d_minerals_n
Physics research.png物理学研究 effect add_deposit=d_physics_n
Society research.png社会学研究 effect add_deposit=d_society_n
Engineering research.png工程学研究 effect add_deposit=d_engineering_n
一次性可以加1-5的
Alloys.png合金 effect add_deposit=d_alloys_n
Volatile motes.png易爆微粒 effect add_deposit=d_volatile_motes_n
Exotic gases.png异星天然气 effect add_deposit=d_exotic_gases_n
Rare crystals.png稀有水晶 effect add_deposit=d_rare_crystals_n
“”贸易价值 effect add_deposit=d_trade_value_n （时间流淌一个月后出现）
Sr zro.png泽珞 effect add_deposit=d_zro_deposit_n
特殊的：
Sr dark matter.png暗物质 effect add_deposit=d_dark_matter_deposit_n （1-3）
Nanites.png纳米机器人 effect add_deposit=d_nanites_deposit （没有参数n，输一遍+1，只能一遍遍输）
Sr living metal.png活体金属 effect add_deposit=d_living_metal_deposit （也没有参数n，输一遍+1，只能一遍遍输）
Food.png食物 effect add_deposit=d_food_3 （目前来看，食物仅能一次加3）
其余无法添加或尚未找到添加方法
注意，并不是什么行星都能添加某种资源的，你毕竟不可能给一个气体巨行星添加易爆微粒！
领导人特性代码
访问专题
这些可以用于 add_trait_leader 命令与remove_trait_leader命令 。与其他命令的用法还未确认。
通用特性
通用特性列表

名称	代码	代号
Leader trait adaptable.png开明	add_trait_leader @ leader_trait_adaptable	40
Leader trait stubborn.png顽固	add_trait_leader @ leader_trait_stubborn	41
Leader trait eager.png活力四射	add_trait_leader @ leader_trait_eager	44
Leader trait arrested development.png没有前途	add_trait_leader @ leader_trait_arrested_development	45
Leader trait glory seeker.png龙见愁	add_trait_leader @ leader_trait_dragonbane	47
Leader trait adaptable.png灵活编程	add_trait_leader @ leader_trait_flexible_programming	132
Leader trait stubborn.png死板编程	add_trait_leader @ leader_trait_rigid_programming	133
Leader trait eager.png新上任	add_trait_leader @ leader_trait_newboot	134
元首特性
元首特性列表

名称	代码	代号
Trait ruler corvette focus.png护卫舰专精	add_trait_leader @ trait_ruler_corvette_focus	68
Trait ruler destroyer focus.png驱逐舰专精	add_trait_leader @ trait_ruler_destroyer_focus	69
Trait ruler cruiser focus.png巡洋舰专精	add_trait_leader @ trait_ruler_cruiser_focus	70
Trait ruler battleship focus.png战列舰专精	add_trait_leader @ trait_ruler_battleship_focus	71
Trait ruler recruiter.png征募者	add_trait_leader @ trait_ruler_recruiter	72
Trait ruler from the ranks.png出身士卒	add_trait_leader @ trait_ruler_from_the_ranks	73
Trait ruler fortifier.png筑防者	add_trait_leader @ trait_ruler_fortifier	74
Trait ruler logistic understanding.png深通后勤	add_trait_leader @ trait_ruler_logistic_understanding	75
Trait ruler military pioneer.png军事先驱	add_trait_leader @ trait_ruler_military_pioneer	76
Leader trait fist.png好战	add_trait_leader @ trait_ruler_warlike	77
Trait ruler architectural sense.png重视建筑	add_trait_leader @ trait_ruler_architectural_sense	78
Trait ruler frontier spirit.png开拓精神	add_trait_leader @ trait_ruler_frontier_spirit	79
Trait ruler world shaper.png星球塑形师	add_trait_leader @ trait_ruler_world_shaper	80
Trait ruler home in the sky.png星辰大海	add_trait_leader @ trait_ruler_home_in_the_sky	81
Trait ruler industrialist.png实业家	add_trait_leader @ trait_ruler_industrialist	82
Trait ruler eye for talent.png伯乐之眼	add_trait_leader @ trait_ruler_eye_for_talent	83
Trait ruler deep connections.png关系深厚	add_trait_leader @ trait_ruler_deep_connections	84
Trait ruler charismatic.png魅力非凡	add_trait_leader @ trait_ruler_charismatic	85
Trait ruler champion of the people.png人民公仆	add_trait_leader @ trait_ruler_champion_of_the_people	86
Trait ruler expansionist.png扩张主义者	add_trait_leader @ trait_ruler_expansionist	87
Trait ruler fertility preacher.png重视农耕	add_trait_leader @ trait_ruler_fertility_preacher	88
Trait ruler investor.png投资者	add_trait_leader @ trait_ruler_investor	89
Trait ruler space miner.png太空矿工	add_trait_leader @ trait_ruler_space_miner	90
Trait ruler explorer.png探险家	add_trait_leader @ trait_ruler_explorer	91
Leader trait fleet organizer.png舰队组织者	add_trait_leader @ leader_trait_fleet_organizer	92
Trait ruler reformer.png改革家	add_trait_leader @ leader_trait_reformer	93
Trait erudite.png博学多识	add_trait_leader @ leader_trait_ruler_erudite	94
Leader trait cyborg.png义体人	add_trait_leader @ leader_trait_ruler_cyborg	95
Leader trait synthetic.png合成人	add_trait_leader @ leader_trait_ruler_synthetic	96
Leader trait psionic leader.png灵媒	add_trait_leader @ leader_trait_ruler_psionic	97
Leader trait psionic chosen one.png天选之人	add_trait_leader @ leader_trait_ruler_chosen	98
Leader trait ruler hive mind.png蜂巢思维	add_trait_leader @ leader_trait_ruler_hive_mind	99
Leader trait great khan.png大可汗	add_trait_leader @ leader_trait_ruler_great_khan	100
Trait machine unit.png机械智能	add_trait_leader @ leader_trait_ruler_machine_intelligence	131
Leader trait nervous.png不稳定代码库	add_trait_leader @ leader_trait_unstable_code_base	143
Trait brainslugged.png脑蛞蝓宿主	add_trait_leader @ leader_trait_ruler_brainslug	280
总督特性
总督特性列表

名称	代码	代号
Leader trait iron fist.png铁拳	add_trait_leader @ leader_trait_iron_fist	48
Leader trait army veteran.png退伍老兵	add_trait_leader @ leader_trait_army_veteran	49
Leader trait retired fleet officer.png退伍海军军官	add_trait_leader @ leader_trait_retired_fleet_officer	50
Leader trait architectural interest.png建筑学爱好者	add_trait_leader @ leader_trait_architectural_interest	51
Leader trait agrarian upbringing.png土地培育师	add_trait_leader @ leader_trait_agrarian_upbringing	52
Leader trait intellectual.png知识分子	add_trait_leader @ leader_trait_intellectual	53
Leader trait environmental engineer.png环境工程师	add_trait_leader @ leader_trait_environmental_engineer	54
Leader trait bureaucrat.png上下同心	add_trait_leader @ leader_trait_bureaucrat	55
Trait erudite.png博学多识	add_trait_leader @ leader_trait_governor_erudite	56
Leader trait cyborg.png义体人	add_trait_leader @ leader_trait_governor_cyborg	57
Leader trait synthetic.png合成人	add_trait_leader @ leader_trait_governor_synthetic	58
Leader trait psionic leader.png灵媒	add_trait_leader @ leader_trait_governor_psionic	59
Leader trait psionic chosen one.png天选之人	add_trait_leader @ leader_trait_governor_chosen	60
Leader trait righteous.png正义凌然	add_trait_leader @ leader_trait_righteous	61
Leader trait corrupt.png贪婪腐败	add_trait_leader @ leader_trait_corrupt	62
Leader trait bureaucrat.png正念	add_trait_leader @ leader_trait_mindfulness	63
Leader trait bureaucrat.png放大电路	add_trait_leader @ leader_trait_amplifier	64
Leader trait hammer.png杀器焊匠	add_trait_leader @ leader_trait_warbot_tinkerer	135
Leader trait ai aided design.pngAI辅助设计	add_trait_leader @ leader_trait_ai_aided_design	136
Leader trait environmental engineer.png推土机	add_trait_leader @ leader_trait_bulldozer	137
Leader trait intellectual.png善于分析	add_trait_leader @ leader_trait_analytical	138
Trait brainslugged.png脑蛞蝓宿主	add_trait_leader @ leader_trait_governor_brainslug	278
Leader trait psionic chosen one.png纳米机器个体	add_trait_leader @ leader_trait_governor_gray	279
Leader trait enclave trader.png城邦商人	add_trait_leader @ leader_trait_enclave_trader	284
Leader trait waste management specialist.png废物处理专家	add_trait_leader @ leader_trait_waste_management_specialist	286
Leader trait nuumismatic priest.png拜金教商人	add_trait_leader @ leader_trait_nuumismatic_priest	287
Leader trait oracle.png神谕	add_trait_leader @ leader_trait_governor_oracle	293
Leader trait prospectorium extractor.png勘探绑开采员	add_trait_leader @ leader_trait_prospectorium_extractor	300
Leader trait prospectorium optimizer.png勘探邦优化员	add_trait_leader @ leader_trait_prospectorium_optimizer	301
Leader trait prospectorium refiner.png勘探邦精炼师	add_trait_leader @ leader_trait_prospectorium_refiner	302
科学家特性
科学家特性列表

名称	代码	代号
Leader trait substance abuser.pngleader_trait_loop_touched	add_trait_leader @ leader_trait_loop_touched	66
Leader trait meticulous.png细致	add_trait_leader @ leader_trait_meticulous	101
Leader trait spark of genius.png灵光一闪	add_trait_leader @ leader_trait_spark_of_genius	102
Leader trait carefree.png无忧无虑	add_trait_leader @ leader_trait_carefree	103
Leader trait roamer.png漫游者	add_trait_leader @ leader_trait_roamer	104
Leader trait archaeologist.png考古学家	add_trait_leader @ leader_trait_archaeologist_ancrel	105
Leader trait archaeologist.png考古学家	add_trait_leader @ leader_trait_archaeologist	106
Leader trait paranoid.png偏执	add_trait_leader @ leader_trait_paranoid	107
Leader trait maniacal.png狂热	add_trait_leader @ leader_trait_maniacal	108
Leader trait custom AI assistant.png定制AI助理	add_trait_leader @ leader_trait_custom_AI_assistant	109
Leader trait sapient AI assistant.png智能AI副官	add_trait_leader @ leader_trait_sapient_AI_assistant	110
Leader trait expertise materials.png专长：材料科学	add_trait_leader @ leader_trait_expertise_materials	111
Leader trait expertise propulsion.png专长：推进力学	add_trait_leader @ leader_trait_expertise_propulsion	112
Leader trait expertise voidcraft.png专长：宇航技术	add_trait_leader @ leader_trait_expertise_voidcraft	113
Leader trait expertise industry.png专长：工业	add_trait_leader @ leader_trait_expertise_industry	114
Leader trait expertise field manipulation.png专长：力场操控	add_trait_leader @ leader_trait_expertise_field_manipulation	115
Leader trait expertise particles.png专长：粒子物理	add_trait_leader @ leader_trait_expertise_particles	116
Leader trait expertise computing.png专长：计算技术	add_trait_leader @ leader_trait_expertise_computing	117
Leader trait expertise psionics.png专长：灵能理论	add_trait_leader @ leader_trait_expertise_psionics	118
Leader trait expertise new worlds.png专长：新世界理论	add_trait_leader @ leader_trait_expertise_new_worlds	119
Leader trait expertise statecraft.png专长：治国术	add_trait_leader @ leader_trait_expertise_statecraft	120
Leader trait expertise biology.png专长：生物学	add_trait_leader @ leader_trait_expertise_biology	121
Leader trait expertise military theory.png专长：军事理论	add_trait_leader @ leader_trait_expertise_military_theory	122
Leader trait curator.png策展人	add_trait_leader @ leader_trait_curator	123
Trait erudite.png博学多识	add_trait_leader @ leader_trait_scientist_erudite	124
Leader trait cyborg.png义体人	add_trait_leader @ leader_trait_scientist_cyborg	125
Leader trait synthetic.png合成人	add_trait_leader @ leader_trait_scientist_synthetic	126
Leader trait psionic leader.png灵媒	add_trait_leader @ leader_trait_scientist_psionic	127
Leader trait psionic chosen one.png天选之人	add_trait_leader @ leader_trait_scientist_chosen	128
Leader trait scroll.png毛巾携带者	add_trait_leader @ leader_trait_towel	129
敲击维护者	add_trait_leader @ leader_trait_percussive_maintainer	130
Leader trait roamer.png目录编纂者	add_trait_leader @ leader_trait_cataloger	144
Trait brainslugged.png脑蛞蝓宿主	add_trait_leader @ leader_trait_scientist_brainslug	274
Leader trait traumatized.png受挫	add_trait_leader @ leader_trait_traumatized	288
Leader trait maimed.png伤残	add_trait_leader @ leader_trait_maimed	289
Leader trait inspired.png受启发的考古学家	add_trait_leader @ leader_trait_inspired_archaeologist	290
Leader trait inspired.png受启发的研究员	add_trait_leader @ leader_trait_inspired_researcher	291
Leader trait inspired.png受启发的调查员	add_trait_leader @ leader_trait_inspired_surveyor	292
Leader trait scholarium investigator.png学邦调查员	add_trait_leader @ leader_trait_scholarium_investigator	297
Leader trait scholarium explorer.png学邦探险家	add_trait_leader @ leader_trait_scholarium_explorer	298
Leader trait scholarium observer.png学邦观察者	add_trait_leader @ leader_trait_scholarium_observer	299
受启发的考古学家：考古发掘速度+1000% 领袖获得经验+25%
受启发的研究员：研究速度+10% 领袖获得经验+25%
受启发的调查员：异常现象研究速度+10% 领袖获得经验+25%

陆军领袖特性
陆军领袖特性列表

名称	代码	代号
Leader trait restrained.png克制	add_trait_leader @ leader_trait_restrained	28
Leader trait charismatic.png魅力非凡	add_trait_leader @ leader_trait_charismatic	29
Leader trait butcher.png屠夫	add_trait_leader @ leader_trait_butcher	30
Leader trait glory seeker.png身先士卒	add_trait_leader @ leader_trait_glory_seeker	31
Leader trait armchair commander.png纸上谈兵	add_trait_leader @ leader_trait_armchair_commander	32
Leader trait army logistician.png陆战队后勤专家	add_trait_leader @ leader_trait_army_logistician	33
Trait erudite.png博学多识	add_trait_leader @ leader_trait_general_erudite	34
Leader trait cyborg.png义体人	add_trait_leader @ leader_trait_general_cyborg	35
Leader trait synthetic.png合成人	add_trait_leader @ leader_trait_general_synthetic	36
Leader trait psionic leader.png灵媒	add_trait_leader @ leader_trait_general_psionic	37
Leader trait psionic chosen one.png天选之人	add_trait_leader @ leader_trait_general_chosen	38
Leader trait glory seeker.png佣兵战士	add_trait_leader @ leader_trait_general_mercenary_warrior	39
Leader trait parts cannibalizer.png零件再利用	add_trait_leader @ leader_trait_parts_cannibalizer	139
Leader trait demoralizer.png灌输恐惧	add_trait_leader @ leader_trait_demoralizer	140
Leader trait erratic morality core.png不稳定道德核心	add_trait_leader @ leader_trait_erratic_morality_core	141
Trait brainslugged.png脑蛞蝓宿主	add_trait_leader @ leader_trait_general_brainslug	275
舰队司令特性
舰队司令特性列表

名称	代码	代号
Leader trait trickster.png战略家	add_trait_leader @ leader_trait_trickster	0
Leader trait fleet logistician.png舰队后勤专家	add_trait_leader @ leader_trait_fleet_logistician	1
Leader trait engineer.png工程师	add_trait_leader @ leader_trait_engineer	2
Leader trait aggressive.png火力全开	add_trait_leader @ leader_trait_aggressive	3
Leader trait cautious.png谨慎	add_trait_leader @ leader_trait_cautious	4
Leader trait scout.png侦查专家	add_trait_leader @ leader_trait_scout	5
Leader trait unyielding.png不屈	add_trait_leader @ leader_trait_unyielding	6
Leader trait nervous.png神经质	add_trait_leader @ leader_trait_nervous	7
Leader trait gale speed.png其疾如风	add_trait_leader @ leader_trait_gale_speed	8
Leader trait lethargic.png懒散	add_trait_leader @ leader_trait_lethargic	9
Leader trait sentinel.png哨兵训练	add_trait_leader @ leader_trait_sentinel	10
Leader trait fist.png蜂巢亲和	add_trait_leader @ leader_trait_hive_affinity	11
Leader trait ship.png虚空猎手	add_trait_leader @ leader_trait_void_swimmer	12
Leader trait ship.png虚无缥缈	add_trait_leader @ leader_trait_ethereal	13
Leader trait ship.png次元巡航	add_trait_leader @ leader_trait_dimensional_stutter	14
Leader trait glory seeker.png屠龙者	add_trait_leader @ leader_trait_dragonslayer	15
Trait aquatic.png水生	add_trait_leader @ leader_trait_aquatic_admiral	16
Trait erudite.png博学多识	add_trait_leader @ leader_trait_admiral_erudite	17
Leader trait cyborg.png义体人	add_trait_leader @ leader_trait_admiral_cyborg	18
Leader trait synthetic.png合成人	add_trait_leader @ leader_trait_admiral_synthetic	19
Leader trait psionic leader.png灵媒	add_trait_leader @ leader_trait_admiral_psionic	20
Leader trait psionic chosen one.png天选之人	add_trait_leader @ leader_trait_admiral_chosen	21
Leader trait fist.png赛博勒克斯数据库	add_trait_leader @ leader_trait_cybrex	22
Leader trait mercenary warrior.png佣兵战士	add_trait_leader @ leader_trait_mercenary_warrior	23
Leader trait great khan.png大可汗	add_trait_leader @ leader_trait_great_khan	24
Leader trait clone soldier.png克隆人部队司令	add_trait_leader @ leader_trait_clone_army_admiral	25
Leader trait clone soldier descendant.png末裔克隆部队司令	add_trait_leader @ leader_trait_clone_army_fertile_admiral	26
Leader trait clone soldier ascendant.png先裔克隆部队司令	add_trait_leader @ leader_trait_clone_army_full_admiral	27
Leader trait ship.png命中注定相会	add_trait_leader @ leader_trait_foredoomed_to_a_rendezvous	67
Leader trait fleet logistician.png维护循环	add_trait_leader @ leader_trait_maintenance_loop	142
Leader trait restore point.png还原点	add_trait_leader @ leader_trait_restore_point	145
Trait brainslugged.png脑蛞蝓宿主	add_trait_leader @ leader_trait_admiral_brainslug	276
Leader trait hells heart.png地狱雄心	add_trait_leader @ leader_trait_admiral_hells_heart	277
Leader trait caravan counter.png行商拦截者	add_trait_leader @ leader_trait_caravan_counter	283
Leader trait bulwark watcher.png戍邦守望者	add_trait_leader @ leader_trait_bulwark_watcher	294
Leader trait bulwark retaliator.png戍邦反击大师	add_trait_leader @ leader_trait_bulwark_retaliator	295
Leader trait bulwark sentinel.png戍邦哨兵	add_trait_leader @ leader_trait_bulwark_sentinel	296
遗珍代码
add_relic <遗珍代码>
遗珍	代码
泽洛魂石	add_relic r_zro_crystal
有机全典	add_relic r_omnicodex
最后的巴奥	add_relic r_the_last_baol
女猎手之刃	add_relic r_ancient_sword
扎克兰的头颅	add_relic r_severed_head
银河之星	add_relic r_galatron
微缩星河	add_relic r_galaxy
索林原虫虫后	add_relic r_prethoryn_queen
碎片整理程序	add_relic r_the_defragmentor
异次元术士	add_relic r_unbidden_warlock
独立的肃正核心	add_relic r_contingency_core
时J之鳞	add_relic r_worm_scales
可汗王座	add_relic r_khans_throne
赛博勒克斯兵工厂	add_relic r_war_forge
沃陶姆现实透孔仪	add_relic r_reality_perforator
尤特冷冻核心	add_relic r_cryo_core
贾沃疹样本	add_relic r_pox_sample
勘探器	add_relic r_surveyor
以太巨龙战利品	add_relic r_dragon_trophy
誊录仪	add_relic r_rubricator
add_relic all 添加全部遗珍

巨构代码
・ effect remove_megastructure = this 移除选中巨构
一般来说最后的数字，0是基址，列表中是成品 
巨构	代码	
已完成的环形世界区段	create_megastructure ring_world_3_intermediate	使用第一次会生成A区段，第二次B区段，以此往复 但会全都缩在恒星的模型里
戴森球	create_megastructure dyson_sphere_5	会自动适应恒星大小
哨兵阵列	create_megastructure spy_orb_4	
科学枢纽	create_megastructure think_tank_3	
星门	create_megastructure gateway_final	
物质解压器	create_megastructure matter_decompressor_4	模型会歪
战略指挥中心	create_megastructure strategic_coordination_center_3	
巨型艺术设施	create_megastructure mega_art_installation_3	
星际集会	create_megastructure interstellar_assembly_4	
居住地	create_megastructure habitat_0	
巨型船坞	create_megastructure mega_shipyard_3	
以太相引擎	create_megastructure crisis_sphere_3	0为损坏版 3为最后一个阶段之前 4为直接建成引擎 事件可正常触发	
量子弹弓	create_megastructure quantum_catapult_3	未经严密测试，但是可用
事件代码
访问专题
这些可以用于 event 命令。与其他命令的用法还未确认。
星球事件需要选定星球再使用控制台，舰船事件需要选定舰船再使用控制台
事件列表：事件控制台列表

矿藏代码
访问专题
这些可以用于 effect add_deposit 命令，格式为 effect add_deposit=d_英文代号_n （n为数量，有的有限制，有的没有这个参数，只能一个，可以叠加，数量过大需要自行摸索） 。与其他命令的用法还未确认。
需要选定星球再使用控制台
修正列表：矿脉专题或矿藏控制台列表

矿物等资源很容易在列表中找到，这边给出较为难找的科研增益； 常用的科研加成地形（加成较为强力的）

稀有带科研加成地块	地块名称	效果
effect add_deposit = d_valley_of_zanaam	扎纳姆山谷	全科研30%加4研究岗位
effect add_deposit = d_central_spire	中央尖塔	全科研15%，加8研究岗位
effect add_deposit = d_relic_dense_ruins	密集废墟	全科研15%，最大地区数-6
effect add_deposit = d_former_relic_world	前遗落星球	全科研10%
effect add_deposit = d_ancient_bombardment_craters	远古弹坑	20%物理和2研究岗位
effect add_deposit = d_ancient_particle_accelerator	远古粒子加速器	20%物理和2研究岗位
effect add_deposit = d_wetware_computer	生体电脑	20%工程2研究岗位
effect add_deposit = d_ancient_battlefield	远古战场	20%工程2研究岗位
effect add_deposit = d_underground_vault	地下避难所	20%社会2研究岗位
effect add_deposit = d_flooded_mounds	被淹没的洞穴	20%社会2研究岗位
effect add_modifier={modifier=magnetic_research_boost}	磁力奇迹(这个是BUFF)	全科研+20%
修正代码
访问专题
这些可以用于 effect add_modifier 命令，格式为effect add_modifier = { modifier = <名称> days = <时间，其中-1为永久> }。与其他命令的用法还未确认。
需要选定星球再使用控制台
修正列表：修正控制台列表


科技代码
访问专题
这些可以用于 research_technology 命令。与其他命令的用法还未确认。
科技列表

巨型装配系统 research_technology tech_mega_assembly
名称	代码	代号
Tech colossus.png巨像	research_technology tech_colossus	0
Tech pk cracker.png地爆天星	research_technology tech_pk_cracker	1
Tech pk shielder.png安乐天使	research_technology tech_pk_shielder	2
Tech pk neutron.png中子灭杀	research_technology tech_pk_neutron	3
Tech pk godray.png神圣激素	research_technology tech_pk_godray	4
Tech pk nanobots.png大气纳米机器人散布	research_technology tech_pk_nanobots	5
Tech btc 1.png星爆器	research_technology tech_btc_1	6
Tech gargantuan evolution.png超体进化	research_technology tech_gargantuan_evolution	7
Tech lgate activation.pngL-星门启动	research_technology tech_lgate_activation	8
Tech repeatable lcluster clue.pngL-星门认知	research_technology tech_repeatable_lcluster_clue	9
Tech experimental subspace navigation.png试验性超空间导航	research_technology tech_experimental_subspace_navigation	10
Tech neuroregeneration.png神经组织工程	research_technology tech_neuroregeneration	11
Tech nanite repair system.png纳米修复系统	research_technology tech_nanite_repair_system	12
Tech solar panel network.png轨道能源转化技术	research_technology tech_solar_panel_network	13
Tech space exploration.png太空探索	research_technology tech_space_exploration	14
Tech corvettes.png护卫舰	research_technology tech_corvettes	15
Tech destroyers.png驱逐舰	research_technology tech_destroyers	16
Tech cruisers.png巡洋舰	research_technology tech_cruisers	17
Tech battleships.png战列舰	research_technology tech_battleships	18
Tech titans.png泰坦	research_technology tech_titans	19
Tech juggernaut.png主宰	research_technology tech_juggernaut	20
Tech corvette build speed.png标准化护卫舰模板	research_technology tech_corvette_build_speed	21
Tech corvette hull 1.png改进护卫舰船体	research_technology tech_corvette_hull_1	22
Tech corvette hull 2.png先进护卫舰船体	research_technology tech_corvette_hull_2	23
Tech destroyer build speed.png标准化驱逐舰模板	research_technology tech_destroyer_build_speed	24
Tech destroyer hull 1.png改进驱逐舰船体	research_technology tech_destroyer_hull_1	25
Tech destroyer hull 2.png先进驱逐舰船体	research_technology tech_destroyer_hull_2	26
Tech cruiser build speed.png标准化巡洋舰模板	research_technology tech_cruiser_build_speed	27
Tech cruiser hull 1.png改进巡洋舰船体	research_technology tech_cruiser_hull_1	28
Tech cruiser hull 2.png先进巡洋舰船体	research_technology tech_cruiser_hull_2	29
Tech battleship build speed.png标准化战列舰模板	research_technology tech_battleship_build_speed	30
Tech battleship hull 1.png改进战列舰船体	research_technology tech_battleship_hull_1	31
Tech battleship hull 2.png先进战列舰船体	research_technology tech_battleship_hull_2	32
Tech titan hull 1.png改进泰坦船体	research_technology tech_titan_hull_1	33
Tech titan hull 2.png先进泰坦船体	research_technology tech_titan_hull_2	34
Tech starbase 1.png恒星基地建设	research_technology tech_starbase_1	35
Tech starbase 2.png星港	research_technology tech_starbase_2	36
Tech starbase 3.png星垒	research_technology tech_starbase_3	37
Tech starbase 4.png星堡	research_technology tech_starbase_4	38
Tech starbase 5.png擎天堡	research_technology tech_starbase_5	39
Tech habitat 1.png轨道居住站	research_technology tech_habitat_1	40
Tech habitat 2.png居住站扩建	research_technology tech_habitat_2	41
Tech habitat 3.png高级太空居住站	research_technology tech_habitat_3	42
Tech modular engineering.png模块化工程	research_technology tech_modular_engineering	43
Tech space defense station improvement.png工兵部队	research_technology tech_space_defense_station_improvement	44
Tech strike craft 1.png航母作战	research_technology tech_strike_craft_1	45
Tech strike craft 2.png改良型舰载机	research_technology tech_strike_craft_2	46
Tech strike craft 3.png先进型舰载机	research_technology tech_strike_craft_3	47
Tech assault armies.png星际远征军	research_technology tech_assault_armies	48
Tech ship armor 1.png纳米复合材料	research_technology tech_ship_armor_1	49
Tech ship armor 2.png瓷金复合材料	research_technology tech_ship_armor_2	50
Tech ship armor 3.png塑钢材料	research_technology tech_ship_armor_3	51
Tech ship armor 4.png耐钢材料	research_technology tech_ship_armor_4	52
Tech ship armor 5.png零素材料	research_technology tech_ship_armor_5	53
Tech crystal armor 1.png水晶复合镀层	research_technology tech_crystal_armor_1	54
Tech crystal armor 2.png水晶锻造镀层	research_technology tech_crystal_armor_2	55
Tech thrusters 1.png化学推进器	research_technology tech_thrusters_1	56
Tech thrusters 2.png离子推进器	research_technology tech_thrusters_2	57
Tech thrusters 3.png等离子推进器	research_technology tech_thrusters_3	58
Tech thrusters 4.png脉冲推进器	research_technology tech_thrusters_4	59
Tech space defense station 1.png深空防御	research_technology tech_space_defense_station_1	60
Tech defense platform hull 1.png改善结构完整性	research_technology tech_defense_platform_hull_1	61
Tech basic industry.png工业基地	research_technology tech_basic_industry	62
Tech mechanized mining.png机械化开采	research_technology tech_mechanized_mining	63
Tech powered exoskeletons.png动力外骨骼	research_technology tech_powered_exoskeletons	64
Tech space mining 1.png零重力精炼厂	research_technology tech_space_mining_1	65
Tech space mining 2.png远距离矿物扫描仪	research_technology tech_space_mining_2	66
Tech space mining 3.png矿石切割束	research_technology tech_space_mining_3	67
Tech space mining 4.png自动采矿无人机	research_technology tech_space_mining_4	68
Tech space mining 5.png纳米矿物探测器	research_technology tech_space_mining_5	69
Tech mining 1.png地热水力压裂	research_technology tech_mining_1	70
Tech mining 2.png地心开采	research_technology tech_mining_2	71
Tech mining 3.png矿物分离	research_technology tech_mining_3	72
Tech mineral purification 1.png矿物提纯	research_technology tech_mineral_purification_1	73
Tech mineral purification 2.png先进矿物提纯	research_technology tech_mineral_purification_2	74
Tech alloys 1.png固态全息铸模	research_technology tech_alloys_1	75
Tech alloys 2.png纳米分离器	research_technology tech_alloys_2	76
Tech advanced metallurgy 1.png陶瓷合金	research_technology tech_advanced_metallurgy_1	77
Tech advanced metallurgy 2.png耐钢合金	research_technology tech_advanced_metallurgy_2	78
Tech luxuries 1.png纳米电路装配	research_technology tech_luxuries_1	79
Tech luxuries 2.png复制机终端	research_technology tech_luxuries_2	80
Tech engineering 1.png纳米力学	research_technology tech_engineering_1	81
Tech engineering 2.png超固体材料	research_technology tech_engineering_2	82
Tech engineering 3.png超流体材料	research_technology tech_engineering_3	83
Tech robotic workers.png机器人劳工	research_technology tech_robotic_workers	84
Tech droid workers.png智能人	research_technology tech_droid_workers	85
Tech synthetic workers.png合成人	research_technology tech_synthetic_workers	86
Tech synthetic leaders.png合成人人格矩阵	research_technology tech_synthetic_leaders	87
Tech space construction.png外太空建设	research_technology tech_space_construction	88
Tech afterburners 1.png加力燃烧室	research_technology tech_afterburners_1	89
Tech afterburners 2.png先进加力燃烧室	research_technology tech_afterburners_2	90
Tech assembly pattern.png装配模式	research_technology tech_assembly_pattern	91
Tech construction templates.png建造模板	research_technology tech_construction_templates	92
Tech housing 1.png气候控制系统	research_technology tech_housing_1	93
Tech housing 2.png反重力工程	research_technology tech_housing_2	94
Tech repeatable improved tile mineral output.png提取模式	research_technology tech_repeatable_improved_tile_mineral_output	95
Tech repeatable improved military station damage.png同步开火模式	research_technology tech_repeatable_improved_military_station_damage	96
Tech repeatable improved military station health.png强化核心层	research_technology tech_repeatable_improved_military_station_health	97
Tech repeatable improved armor output.png物质压缩	research_technology tech_repeatable_improved_armor_output	98
Tech repeatable weapon type explosive damage.png热力学当量控制	research_technology tech_repeatable_weapon_type_explosive_damage	99
Tech repeatable weapon type explosive fire rate.png小型预点火装置	research_technology tech_repeatable_weapon_type_explosive_fire_rate	100
Tech repeatable weapon type kinetic damage.png高密度弹药	research_technology tech_repeatable_weapon_type_kinetic_damage	101
Tech repeatable weapon type kinetic fire rate.png装载效率	research_technology tech_repeatable_weapon_type_kinetic_fire_rate	102
Tech repeatable weapon type strike craft fire damage.png突触拦截器	research_technology tech_repeatable_weapon_type_strike_craft_fire_damage	103
Tech repeatable weapon type strike craft fire rate.png热力循环器	research_technology tech_repeatable_weapon_type_strike_craft_fire_rate	104
Tech repeatable reduced building time.png组装算法	research_technology tech_repeatable_reduced_building_time	105
Tech mass drivers 1.png质量投射器	research_technology tech_mass_drivers_1	106
Tech mass drivers 2.png线圈炮	research_technology tech_mass_drivers_2	107
Tech mass drivers 3.png轨道炮	research_technology tech_mass_drivers_3	108
Tech mass drivers 4.png先进轨道炮	research_technology tech_mass_drivers_4	109
Tech mass drivers 5.png高斯炮	research_technology tech_mass_drivers_5	110
Tech kinetic artillery 1.png动能火炮	research_technology tech_kinetic_artillery_1	111
Tech kinetic artillery 2.png先进动能火炮	research_technology tech_kinetic_artillery_2	112
Tech mass accelerator 1.png兆级加农炮	research_technology tech_mass_accelerator_1	113
Tech mass accelerator 2.png千兆级加农炮	research_technology tech_mass_accelerator_2	114
Tech autocannons 1.png机关炮	research_technology tech_autocannons_1	115
Tech autocannons 2.png撕裂者机关炮	research_technology tech_autocannons_2	116
Tech autocannons 3.png火风暴机关炮	research_technology tech_autocannons_3	117
Tech flak batteries 1.png高射炮	research_technology tech_flak_batteries_1	118
Tech flak batteries 2.png高射加农炮	research_technology tech_flak_batteries_2	119
Tech flak batteries 3.png重型高射炮	research_technology tech_flak_batteries_3	120
Tech missiles 1.png核导弹	research_technology tech_missiles_1	121
Tech missiles 2.png聚变核导弹	research_technology tech_missiles_2	122
Tech missiles 3.png反物质导弹	research_technology tech_missiles_3	123
Tech missiles 4.png量子导弹	research_technology tech_missiles_4	124
Tech missiles 5.png掠夺者导弹	research_technology tech_missiles_5	125
Tech swarmer missiles 1.png蜂群导弹	research_technology tech_swarmer_missiles_1	126
Tech swarmer missiles 2.png旋风导弹	research_technology tech_swarmer_missiles_2	127
Tech torpedoes 1.png太空鱼雷	research_technology tech_torpedoes_1	128
Tech torpedoes 2.png装甲鱼雷	research_technology tech_torpedoes_2	129
Tech torpedoes 3.png毁灭者鱼雷	research_technology tech_torpedoes_3	130
Tech dark matter deflector.png暗物质偏导护盾	research_technology tech_dark_matter_deflector	131
Tech dark matter power core.png暗物质能源	research_technology tech_dark_matter_power_core	132
Tech dark matter propulsion.png暗物质推进	research_technology tech_dark_matter_propulsion	133
Tech akx worm 1.png熵递归	research_technology tech_akx_worm_1	134
Tech akx worm 2.png学说：奇异循环	research_technology tech_akx_worm_2	135
Tech akx worm 3.png欧米伽理论	research_technology tech_akx_worm_3	136
Tech dragon armor.png人造龙鳞装甲	research_technology tech_dragon_armor	137
Tech enigmatic encoder.png神秘编码器	research_technology tech_enigmatic_encoder	138
Tech enigmatic decoder.png神秘解码器	research_technology tech_enigmatic_decoder	139
Tech orbital trash dispersal.png轨道垃圾散布	research_technology tech_orbital_trash_dispersal	140
Tech xeno tourism agency.png外星拓展中介	research_technology tech_xeno_tourism_agency	141
Tech executive retreat.png高管休闲项目	research_technology tech_executive_retreat	142
Tech mega engineering.png巨型结构工程	research_technology tech_mega_engineering	143
Tech science nexus.png科学枢纽	research_technology tech_science_nexus	144
Tech sentry array.png哨兵阵列	research_technology tech_sentry_array	145
Tech strategic coordination.png战略指挥中心	research_technology tech_strategic_coordination	146
Tech interstellar assembly.png星际集会	research_technology tech_interstellar_assembly	147
Tech mega art.png巨型艺术设施	research_technology tech_mega_art	148
Tech gateway activation.png星门激活	research_technology tech_gateway_activation	149
Tech gateway construction.png星门建造	research_technology tech_gateway_construction	150
Tech dyson sphere.png戴森球	research_technology tech_dyson_sphere	151
Tech matter decompressor.png物质解压器	research_technology tech_matter_decompressor	152
Tech ring world.png环形世界	research_technology tech_ring_world	153
Tech mega shipyard.png巨型船坞	research_technology tech_mega_shipyard	154
Tech quantum catapult.png量子弹弓	research_technology tech_quantum_catapult	155
Tech orbital ring tier 1.png星环基地	research_technology tech_orbital_ring_tier_1	156
Tech hyper relays.png超空间中继器	research_technology tech_hyper_relays	157
Tech basic science lab 1.png科学方法	research_technology tech_basic_science_lab_1	158
Tech basic science lab 2.png外星材料实验室	research_technology tech_basic_science_lab_2	159
Tech basic science lab 3.png多维研究	research_technology tech_basic_science_lab_3	160
Tech global research initiative.png跨行星研究倡议	research_technology tech_global_research_initiative	161
Tech curator lab.png策展人探索实验室	research_technology tech_curator_lab	162
Tech archeology lab.png策展人考古实验室	research_technology tech_archeology_lab_ancrel	163
Tech archeology lab.png策展人考古实验室	research_technology tech_archeology_lab	164
Tech space science 1.png零重力实验室	research_technology tech_space_science_1	165
Tech space science 2.png微型遏制力场	research_technology tech_space_science_2	166
Tech space science 3.png量子探测器	research_technology tech_space_science_3	167
Tech space science 4.png自主运行空间站协议	research_technology tech_space_science_4	168
Tech space science 5.png多维分析	research_technology tech_space_science_5	169
Tech physics 1.png量子理论	research_technology tech_physics_1	170
Tech physics 2.png应用量子力学	research_technology tech_physics_2	171
Tech physics 3.png时空理论	research_technology tech_physics_3	172
Tech administrative ai.png管理型人工智能	research_technology tech_administrative_ai	173
Tech cryostasis 1.png人工智能殖民船	research_technology tech_cryostasis_1	174
Tech cryostasis 2.png自我意识殖民船	research_technology tech_cryostasis_2	175
Tech self aware logic.png自我演化逻辑	research_technology tech_self_aware_logic	176
Tech automated exploration.png自动探索协议	research_technology tech_automated_exploration	177
Tech sapient ai.png正电子人工智能	research_technology tech_sapient_ai	178
Tech positronic implants.png正电子脑植入体	research_technology tech_positronic_implants	179
Tech combat computers 1.png特种作战计算机	research_technology tech_combat_computers_1	180
Tech combat computers 2.png拓展战斗算法	research_technology tech_combat_computers_2	181
Tech combat computers 3.png知性战斗模拟	research_technology tech_combat_computers_3	182
Tech combat computers autonomous.png自律舰船智能	research_technology tech_combat_computers_autonomous	183
Tech auxiliary fire control.png辅助火控	research_technology tech_auxiliary_fire_control	184
Tech synchronized defences.png同步防御	research_technology tech_synchronized_defences	185
Tech consumer good refinement 1.png市场分析算法	research_technology tech_consumer_good_refinement_1	186
Tech consumer good refinement 2.png预测消费	research_technology tech_consumer_good_refinement_2	187
Tech encryption 1.png量子防火墙	research_technology tech_encryption_1	188
Tech encryption 2.png同时崩塌存储	research_technology tech_encryption_2	189
Tech encryption 3.png负时间密钥	research_technology tech_encryption_3	190
Tech decryption 1.png量子骇客	research_technology tech_decryption_1	191
Tech decryption 2.png模拟社会工程	research_technology tech_decryption_2	192
Tech decryption 3.png准维映射	research_technology tech_decryption_3	193
Tech fission power.png裂变能源	research_technology tech_fission_power	194
Tech fusion power.png聚变能源	research_technology tech_fusion_power	195
Tech cold fusion power.png冷核聚变能源	research_technology tech_cold_fusion_power	196
Tech antimatter power.png反物质能源	research_technology tech_antimatter_power	197
Tech zero point power.png零点能源	research_technology tech_zero_point_power	198
Tech reactor boosters 1.png反应堆增压器	research_technology tech_reactor_boosters_1	199
Tech reactor boosters 2.png改良反应堆增压器	research_technology tech_reactor_boosters_2	200
Tech reactor boosters 3.png先进反应堆增压器	research_technology tech_reactor_boosters_3	201
Tech shields 1.png偏射盾	research_technology tech_shields_1	202
Tech shields 2.png改良偏射盾	research_technology tech_shields_2	203
Tech shields 3.png护盾	research_technology tech_shields_3	204
Tech shields 4.png先进护盾	research_technology tech_shields_4	205
Tech shields 5.png超级护盾	research_technology tech_shields_5	206
Tech shield rechargers 1.png护盾电容	research_technology tech_shield_rechargers_1	207
Tech planetary shield generator.png行星护盾	research_technology tech_planetary_shield_generator	208
Tech sensors 2.png重力传感器	research_technology tech_sensors_2	209
Tech sensors 3.png亚空间传感器	research_technology tech_sensors_3	210
Tech sensors 4.png快子传感器	research_technology tech_sensors_4	211
Tech power plant 1.png高能电容器	research_technology tech_power_plant_1	212
Tech power plant 2.png力场调制	research_technology tech_power_plant_2	213
Tech power plant 3.png量子能态	research_technology tech_power_plant_3	214
Tech power plant 4.png量子场操控	research_technology tech_power_plant_4	215
Tech power hub 1.png全球能源管理	research_technology tech_power_hub_1	216
Tech power hub 2.png行星电力网	research_technology tech_power_hub_2	217
Tech hyper drive 1.png超空间移动	research_technology tech_hyper_drive_1	218
Tech hyper drive 2.png超空间航道突破点	research_technology tech_hyper_drive_2	219
Tech hyper drive 3.png超空间滑流	research_technology tech_hyper_drive_3	220
Tech wormhole stabilization.png虫洞稳定	research_technology tech_wormhole_stabilization	221
Tech jump drive 1.png跃迁引擎	research_technology tech_jump_drive_1	222
Tech ftl inhibitor.png超光速抑制	research_technology tech_ftl_inhibitor	223
Tech bio reactor.png生物反应堆	research_technology tech_bio_reactor	224
Tech repeatable improved tile energy output.png超导应用	research_technology tech_repeatable_improved_tile_energy_output	225
Tech repeatable improved shield output.png护盾数律分析	research_technology tech_repeatable_improved_shield_output	226
Tech repeatable weapon type energy damage.png聚焦阵列	research_technology tech_repeatable_weapon_type_energy_damage	227
Tech repeatable weapon type energy fire rate.png快速冷却剂	research_technology tech_repeatable_weapon_type_energy_fire_rate	228
Tech repeatable reduced building cost.png引力分析	research_technology tech_repeatable_reduced_building_cost	229
Tech lasers 1.png红激光发射器	research_technology tech_lasers_1	230
Tech lasers 2.png蓝激光发射器	research_technology tech_lasers_2	231
Tech lasers 3.png紫外激光发射器	research_technology tech_lasers_3	232
Tech lasers 4.pngX射线发射器	research_technology tech_lasers_4	233
Tech lasers 5.png伽马激光	research_technology tech_lasers_5	234
Tech energy lance 1.png粒子光矛	research_technology tech_energy_lance_1	235
Tech energy lance 2.png快子光矛	research_technology tech_energy_lance_2	236
Tech plasma 1.png等离子发射器	research_technology tech_plasma_1	237
Tech plasma 2.png等离子加速器	research_technology tech_plasma_2	238
Tech plasma 3.png等离子加农炮	research_technology tech_plasma_3	239
Tech arc emitter 1.png电弧发射器	research_technology tech_arc_emitter_1	240
Tech arc emitter 2.png聚能电弧发射器	research_technology tech_arc_emitter_2	241
Tech disruptors 1.png裂解炮	research_technology tech_disruptors_1	242
Tech disruptors 2.png离子裂解炮	research_technology tech_disruptors_2	243
Tech disruptors 3.png相位裂解炮	research_technology tech_disruptors_3	244
Tech energy torpedoes 1.png质子发射器	research_technology tech_energy_torpedoes_1	245
Tech energy torpedoes 2.png中子发射器	research_technology tech_energy_torpedoes_2	246
Tech pd tracking 1.png主动反制	research_technology tech_pd_tracking_1	247
Tech pd tracking 2.png互联支援系统	research_technology tech_pd_tracking_2	248
Tech pd tracking 3.png预测算法	research_technology tech_pd_tracking_3	249
Tech extradimensional weapon 1.png高维武器	research_technology tech_extradimensional_weapon_1	250
Tech mining drone weapon 1.png采矿无人机激光	research_technology tech_mining_drone_weapon_1	251
Tech space cloud weapon 1.png雷云导线	research_technology tech_space_cloud_weapon_1	252
Null void beam.png太虚光束	research_technology null_void_beam	253
Tech planetary defenses.png行星防御	research_technology tech_planetary_defenses	254
Tech interplanetary commerce.png星际贸易	research_technology tech_interplanetary_commerce	255
Tech space trading.png外星贸易公司	research_technology tech_space_trading	256
Tech interstellar economics.png星际经济学	research_technology tech_interstellar_economics	257
Tech galactic markets.png泛星系贸易市场	research_technology tech_galactic_markets	258
Tech prescient data modeling.png拜金教数据建模	research_technology tech_prescient_data_modeling	259
Tech industrial farming.png农业工业化	research_technology tech_industrial_farming	260
Tech eco simulation.png生态模拟	research_technology tech_eco_simulation	261
Tech gene crops.png转基因作物	research_technology tech_gene_crops	262
Tech nano vitality crops.png纳米活性作物	research_technology tech_nano_vitality_crops	263
Tech nutrient replication.png营养复制	research_technology tech_nutrient_replication	264
Tech hydroponics.png水培农业	research_technology tech_hydroponics	265
Tech food processing 1.png食品加工	research_technology tech_food_processing_1	266
Tech food processing 2.png高级食品加工	research_technology tech_food_processing_2	267
Tech society 1.png生物多样性研究	research_technology tech_society_1	268
Tech society 2.png异种生物学	research_technology tech_society_2	269
Tech society 3.png生命的秘密	research_technology tech_society_3	270
Tech alien life studies.png异种生物学	research_technology tech_alien_life_studies	271
Tech arcane deciphering.png奥术解密	research_technology tech_arcane_deciphering	272
Tech colonization 1.png新世界协议	research_technology tech_colonization_1	273
Tech colonization 2.png大气过滤	research_technology tech_colonization_2	274
Tech colonization 3.png恶劣环境适应	research_technology tech_colonization_3	275
Tech colonization 4.png外星土壤肥化	research_technology tech_colonization_4	276
Tech colonization 5.png生态整合研究	research_technology tech_colonization_5	277
Tech tomb world adaption.png死寂星球适应	research_technology tech_tomb_world_adaption	278
Tech frontier health.png基因健康保障	research_technology tech_frontier_health	279
Tech frontier hospital.png细胞修复	research_technology tech_frontier_hospital	280
Tech mountain range.png地表重塑	research_technology tech_mountain_range	281
Tech volcano.png地壳深部工程	research_technology tech_volcano	282
Tech dangerous wildlife.png清除危险野生动物	research_technology tech_dangerous_wildlife	283
Tech dense jungle.png选择性脱叶剂	research_technology tech_dense_jungle	284
Tech quicksand basin.png土壤修复	research_technology tech_quicksand_basin	285
Tech noxious swamp.png异种水力掌控	research_technology tech_noxious_swamp	286
Tech massive glacier.png气候控制网络	research_technology tech_massive_glacier	287
Tech toxic kelp.png海洋生态管理	research_technology tech_toxic_kelp	288
Tech deep sinkhole.png地下殖民	research_technology tech_deep_sinkhole	289
Tech terrestrial sculpting.png地表塑造	research_technology tech_terrestrial_sculpting	290
Tech ecological adaptation.png生态适应	research_technology tech_ecological_adaptation	291
Tech climate restoration.png气候复苏	research_technology tech_climate_restoration	292
Tech genome mapping.png基因图谱	research_technology tech_genome_mapping	293
Tech vitality boosters.png活性增强剂	research_technology tech_vitality_boosters	294
Tech epigenetic triggers.png表观遗传学机制	research_technology tech_epigenetic_triggers	295
Tech cloning.png克隆	research_technology tech_cloning	296
Tech gene banks.png基因库	research_technology tech_gene_banks	297
Tech gene seed purification.png基因种子纯化	research_technology tech_gene_seed_purification	298
Tech morphogenetic field mastery.png形态发生学精通	research_technology tech_morphogenetic_field_mastery	299
Tech gene tailoring.png基因剪裁	research_technology tech_gene_tailoring	300
Tech glandular acclimation.png腺体适应	research_technology tech_glandular_acclimation	301
Tech genetic resequencing.png基因重组	research_technology tech_genetic_resequencing	302
Tech gene expressions.png基因定向表达	research_technology tech_gene_expressions	303
Tech selected lineages.png择优血脉	research_technology tech_selected_lineages	304
Tech capacity boosters.png能力增强	research_technology tech_capacity_boosters	305
Tech regenerative hull tissue.png再生舰体组织	research_technology tech_regenerative_hull_tissue	306
Tech doctrine fleet size 1.png学说：太空战斗	research_technology tech_doctrine_fleet_size_1	307
Tech doctrine fleet size 2.png学说：灵巧编队	research_technology tech_doctrine_fleet_size_2	308
Tech doctrine fleet size 3.png学说：星际战争	research_technology tech_doctrine_fleet_size_3	309
Tech doctrine fleet size 4.png学说：机动舰队模板	research_technology tech_doctrine_fleet_size_4	310
Tech doctrine fleet size 5.png学说：舰队阵型	research_technology tech_doctrine_fleet_size_5	311
Tech interstellar fleet traditions.png星际舰队传统	research_technology tech_interstellar_fleet_traditions	312
Tech refit standards.png改装标准	research_technology tech_refit_standards	313
Tech command matrix.png指挥矩阵	research_technology tech_command_matrix	314
Tech doctrine navy size 1.png学说：舰队支援	research_technology tech_doctrine_navy_size_1	315
Tech doctrine navy size 2.png学说：支援船队	research_technology tech_doctrine_navy_size_2	316
Tech doctrine navy size 3.png学说：星际后勤	research_technology tech_doctrine_navy_size_3	317
Tech doctrine navy size 4.png学说：舰队联络	research_technology tech_doctrine_navy_size_4	318
Tech centralized command.png集中指挥	research_technology tech_centralized_command	319
Tech combat training.png战斗训练	research_technology tech_combat_training	320
Tech ground defense planning.png地面防御计划	research_technology tech_ground_defense_planning	321
Tech global defense grid.png全球防御网络	research_technology tech_global_defense_grid	322
Tech psionic theory.png灵能理论	research_technology tech_psionic_theory	323
Tech telepathy.png心灵感应	research_technology tech_telepathy	324
Tech precognition interface.png预知接口	research_technology tech_precognition_interface	325
Tech thought enforcement.png思想钢印	research_technology tech_thought_enforcement	326
Tech psi jump drive 1.png灵能跃迁引擎	research_technology tech_psi_jump_drive_1	327
Tech galactic ambitions.png星际扩张	research_technology tech_galactic_ambitions	328
Tech manifest destiny.png昭昭天命	research_technology tech_manifest_destiny	329
Tech interstellar campaigns.png星际战役	research_technology tech_interstellar_campaigns	330
Tech galactic campaigns.png星河战役	research_technology tech_galactic_campaigns	331
Tech planetary government.png行星政府	research_technology tech_planetary_government	332
Tech planetary unification.png行星统一	research_technology tech_planetary_unification	333
Tech colonial centralization.png殖民集中	research_technology tech_colonial_centralization	334
Tech galactic administration.png星系管理	research_technology tech_galactic_administration	335
Tech planetary infrastructure 1.png瓷金基础设施	research_technology tech_planetary_infrastructure_1	336
Tech planetary infrastructure 2.png耐钢基础设施	research_technology tech_planetary_infrastructure_2	337
Tech subdermal stimulation.png皮下刺激	research_technology tech_subdermal_stimulation	338
Tech tracking implants.png追踪植入体	research_technology tech_tracking_implants	339
Tech global production strategy.png全球生产策略	research_technology tech_global_production_strategy	340
Tech adaptive bureaucracy.png灵活机构	research_technology tech_adaptive_bureaucracy	341
Tech effective bureaucracy.png高效吏治	research_technology tech_effective_bureaucracy	342
Tech colonial bureaucracy.png殖民官僚制	research_technology tech_colonial_bureaucracy	343
Tech galactic bureaucracy.png星河官僚制	research_technology tech_galactic_bureaucracy	344
Tech living state.png活体国度	research_technology tech_living_state	345
Tech collective self.png集体自我	research_technology tech_collective_self	346
Tech autonomous agents.png自主代理	research_technology tech_autonomous_agents	347
Tech embodied dynamism.png具现物力论	research_technology tech_embodied_dynamism	348
Tech neural implants.png神经植入体	research_technology tech_neural_implants	349
Tech artificial moral codes.png人工道德规范	research_technology tech_artificial_moral_codes	350
Tech synthetic thought patterns.png综合思维模式	research_technology tech_synthetic_thought_patterns	351
Tech unity of purpose.png齐心协力	research_technology tech_unity_of_purpose	352
Tech collective production methods.png集体生产方法	research_technology tech_collective_production_methods	353
Tech resource processing algorithms.png资源处理算法	research_technology tech_resource_processing_algorithms	354
Tech holo entertainment.png全息影像娱乐	research_technology tech_holo_entertainment	355
Tech hyper entertainment forum.png极乐广场	research_technology tech_hyper_entertainment_forum	356
Tech paradise dome.png田园建筑学	research_technology tech_paradise_dome	357
Tech cultural heritage.png社会文化历史	research_technology tech_cultural_heritage	358
Tech heritage site.png传承遗迹	research_technology tech_heritage_site	359
Tech hypercomms forum.png本地超通讯	research_technology tech_hypercomms_forum	360
Tech autocurating vault.png自动综合处理算法	research_technology tech_autocurating_vault	361
Tech holographic rituals.png全息仪式	research_technology tech_holographic_rituals	362
Tech consecration fields.png授圣力场	research_technology tech_consecration_fields	363
Tech transcendent faith.png超意识信仰	research_technology tech_transcendent_faith	364
Tech hive node.png突触建筑	research_technology tech_hive_node	365
Tech hive cluster.png簇状突触	research_technology tech_hive_cluster	366
Tech hive confluence.png思想集簇	research_technology tech_hive_confluence	367
Tech ascension theory.png飞升理论	research_technology tech_ascension_theory	368
Tech psionic barrier.png灵能屏障	research_technology tech_psionic_barrier	369
Tech psionic shield.png灵能护盾	research_technology tech_psionic_shield	370
Tech penal colonies.png流放地	research_technology tech_penal_colonies	371
Tech resort colonies.png度假星球	research_technology tech_resort_colonies	372
Tech slave colonies.png奴隶星球	research_technology tech_slave_colonies	373
Tech housing agrarian idyll.png农业乌托邦	research_technology tech_housing_agrarian_idyll	374
Tech xeno diplomacy.png异种外交	research_technology tech_xeno_diplomacy	375
Tech xeno relations.png异星关系学	research_technology tech_xeno_relations	376
Tech capital productivity 1.png改进生产	research_technology tech_capital_productivity_1	377
Tech capital productivity 2.png规模效应	research_technology tech_capital_productivity_2	378
Tech capital productivity 3.png最大化产能	research_technology tech_capital_productivity_3	379
Tech repeatable improved tile food output.png转基因作物	research_technology tech_repeatable_improved_tile_food_output	380
Tech repeatable improved core system cap.png行政效率	research_technology tech_repeatable_improved_core_system_cap	381
Tech repeatable improved army damage.png主动适应	research_technology tech_repeatable_improved_army_damage	382
Tech repeatable improved army health.png神经抑制器	research_technology tech_repeatable_improved_army_health	383
Tech repeatable improved leader life span.png细胞活力	research_technology tech_repeatable_improved_leader_life_span	384
Tech repeatable naval cap.png舰队管理规程	research_technology tech_repeatable_naval_cap	385
Tech repeatable command limit.png司令幕僚	research_technology tech_repeatable_command_limit	386
Tech repeatable improved starbase capacity.png星际扩张	research_technology tech_repeatable_improved_starbase_capacity	387
Tech amoeba strike craft 1.png变形虫育种计划	research_technology tech_amoeba_strike_craft_1	388
Tech swarm strike craft 1.png虫群产卵池	research_technology tech_swarm_strike_craft_1	389
Tech scourge missile 1.png天灾导弹	research_technology tech_scourge_missile_1	390
Tech space whale weapon 1.png频率调谐	research_technology tech_space_whale_weapon_1	391
Tech mine living metal.png活体金属	research_technology tech_mine_living_metal	392
Tech mine betharian.png贝赛里安精炼	research_technology tech_mine_betharian	393
Tech volatile motes.png微粒稳定化	research_technology tech_mine_volatile_motes	394
Tech volatile motes.png易爆材料生产厂	research_technology tech_volatile_motes	395
Tech exotic gases.png异星天然气开采	research_technology tech_mine_exotic_gases	396
Tech exotic gases.png异星天然气精炼	research_technology tech_exotic_gases	397
Tech mine rare crystals.png稀有水晶开采	research_technology tech_mine_rare_crystals	398
Tech rare crystals.png稀有水晶生产	research_technology tech_rare_crystals	399
Tech mine zro.png蒸馏泽珞	research_technology tech_mine_zro	400
Tech mine dark matter.png暗物质收集	research_technology tech_mine_dark_matter	401
Tech nanite transmutation.png纳米变形	research_technology tech_nanite_transmutation	402
Tech robomodding m.png机械模板系统	research_technology tech_robomodding_m	403
Tech robomodding.png机械模板系统	research_technology tech_robomodding	404
Tech robomodding points 1.png交叉模组标准化	research_technology tech_robomodding_points_1	405
Tech robomodding points 2.png可替换电路	research_technology tech_robomodding_points_2	406
Tech binary motivators.png二进制内驱程序	research_technology tech_binary_motivators	407
Tech nanite assemblers.png纳米装配机	research_technology tech_nanite_assemblers	408
Tech mega assembly.png巨型装配系统	research_technology tech_mega_assembly	409
Tech adaptive combat algorithms.png自适应作战算法	research_technology tech_adaptive_combat_algorithms	410
Tech biomechanics.png生物力学	research_technology tech_biomechanics	411
Tech micro replicators.png微型复制机	research_technology tech_micro_replicators	412
Tech self assembling components.png自动组装部件	research_technology tech_self_assembling_components	413
